wwwwwwwwwwwwwwwwwww
w'''''''''''''''''w
w''''''''P''''''''w
w'''''''''''''''''w
w'''''''''''''''''w
w'''''''''''''''''w
w'''w'''''''''w'''w
w'''''''''''''''''w
w''''''''w''''''''w
w''''''''w''''''''w
w''''''wwwww''''''w
w''''''''w''''''''w
w''''''''w''''''''w
w'''''''''''''''''w
w'''''''''''''''''w
w'''w'''''''''w'''w
w'''''''''''''''''w
w'''''''''''''''''w
w'''''''''''''''''w
wwwwwwwwwwwwwwwwwww
