wwwwwwwwwwwwwwwwwwwwwwwwwwwwwwwwww
w''''''''''''''''''''''''''''''''w
w''''''''''''''''''''''''''''''''w
w'''''''''''''''''w'''''''s''''''w
w'''''''P'''''''''w''''''''''''''w
w'''''''''''''''''w''''''''''''''w
w'''''''''''''''''w''''''''''''''w
w'''''''''''''''''''''''''Z''''''w
w''''''''''''''''''''''''''''''''w
w''''''''''''''''''''''''''''''''w
w''''''''''''''''''''''''''''''''w
wwwwwwwwwwwwwwwwwwwwwwwwwwwwwwwwww
